R____________L
H__]....,..E.H
H______]O[___H
H..E..P.%.E.,H
H__________]OH
H..,.E.,....OH
H__O___O____OH
H.,%[_]%.,..%H
H_O______O___H
H.%E.,.[_O___H
H____O__]%..,H
HE...%Y#..E.%H
>____________<