R____________L
H__]..E.,..E.H
H______]O[___H
H..E..P.%...,H
H__________]OH
H..,...,....OH
H__O___O____OH
H.,%[_]%.,E.%H
H_O______O___H
H.%..,.[_O___H
H____O__]%..,H
HE...%.#....%H
>____________<