R_________________________________________________________L________________________________
H.........................................................H____<____________>______________
H.........................................................H____H____________H______________
H..........................................,..............H____H____________H______________
H............,....................,.......[O].............H____H____________H______________
H...........[O]..................[O].......%......,.......H____H____________H______________
H __________]O[___________].......%..........E....%.......H____H____________H______________
H........,.#.%...................,........................L____R____________L______________
H........O.......................%....................P.#,..............................Y.H
H........%.......E............E............,.......E.....O<____>____________<______________
H...............E........E.........E.......%.............%H____H____________H______________
H.........................................................H____H____________H______________
H.........................................................H____H____________H______________
H.........................................................H____H____________H______________
H.........................................................H____H____________H______________
H.........................................................H____L____________R______________
>_________________________________________________________<________________________________